50000000000000000000
50000000000000000000
50000000000000000000
50000000000000000000
50000000000000000000
50000000000000000000
50000000000000000000
50000000000000000000
50000000000000000000
50000000000000000000
50000000000000000000
50000000000000000000
5000000bbbb000000000
5000000baab000000000
5000000baab000000000
5000000bbbb000000000
50000000000000000000
50000000000000000000
50000000000000000000
50000000000000000000
50000000000000000000
50000000000000000000
50000000000000000000
5000000000bc00000000
500000000a00d0000000
500000000a00d0000000
6000000000bc00000000
60000000000000000000
60000000000000000000
60000000000000000000
6x000000000000000000
60000000000000000000
60000000000000000000
60000000000000000000
60000000000000000000
6000000aa00000000000
6000000aa00000000000
60000000000000000000
6000000000ee00000000
6000000000ee00000000
60000000000000000000
60000000000000000000
60000000000000000000
6y000000000000000000
60000000000000000000
60000000000000000000
60000000000000000000
60000000cba000000000
60000000bcb000000000
60000000abc000000000
60000000000000000000
60000000000000000000
60000000000000000000
60000000000000000000
60000000000000000000
60000000000000000000
6000000000b00b000000
60000000000ee0000000
60000000000ee0000000
6000000000b00b000000
60000000000000000000
60000000000000000000
60000000000000000000
60000000000000000000
40000000000000000000
40000000000000000000
40000000000000000000
40000000000000000000
40000000000000000000
40000000b00000000000
4000000bab0000000000
40000000b00000000000
40000000000000000000
40000000000000000000
40000000000000000000
40000000000000000000
400000000000dd000000
400000000000dd000000
40000000000000000000
40000000000000000000
40000000000000000000
4x000000000000000000
40000000000000000000
40000000000000000000
40000000000000000000
400000a0000000000000
40000aea000000000000
400000a0000000000000
40000000000000000000
40000000000000000000
60000000000000000000
60000000000000000000
60000000000000000000
6x000000000000000000
60000000000000000000
60000000000000000000
60000000000000000000
6000000dd00000000000
600000daad0000000000
600000daad0000000000
6000000dd00000000000
60000000000000000000
60000000000000000000
60000000000000000000
60000000000000000000
60000000000000000000
60000000000000000000
60000000000000000000
60000000000000000000
60000000bb0000000000
50000000bb0000000000
50000000000000000000
50000000000000000000
50000000000000000000
50000000000000000000
5y000000000000000000
50000000000000000000
50000000000000000000
50000000000000000000
50000000000000000000
500000ada00000000000
500000d0d00000000000
500000ada00000000000
50000000000000000000
50000000000000000000
50000000000000000000
50000000000000000000
50000000000000000000
