50000000000000000000
50000000000000000000
50000000000000000000
50000000000000000000
50000000a0b000000000
50000000a0b000000000
50000000a0b000000000
50000000a0b000000000
50000000a0b000000000
50000000a0b000000000
50000000a0b000000000
40000000a0b000000000
40000000a0b000000000
40000000a0b000000000
40000000000000000000
40000000000000000000
40000000000000000000
40000000000000000000
40000000000000000000
4x000000000000000000
40000000000000000000
40000000000000000000
40000000000000000000
40000000000000000000
40000000000000000000
4000000000cccc000000
4000000000caac000000
4000000000caac000000
4000000000cccc000000
40000000000000000000
40000000000000000000
40000000000000000000
40000000000000000000
40000000000000000000
40000000000000000000
40000000000000000000
4000000000a000000000
4000000000b000000000
4000000000a000000000
4000000dd0b000000000
4000000dd0a000000000
4000000000b000000000
6000000000a000000000
6000000000b000000000
60000000000000000000
60000000000000000000
60000000000000000000
60000000000000000000
60000000000000000000
60000000000000000000
60000000000000000000
6x000000000000000000
60000000000000000000
60000000000000000000
60000000000000000000
6000000000000b000000
6000000000000b000000
6000000000000b000000
60000000000000000000
60000000000000000000
6000000000000b000000
6000000000000b000000
6000000000000b000000
60000000000000000000
60000000000000000000
60000000000000000000
60000000000000000000
60000000000000000000
60000000000000000000
70000000000000000000
70000000000000000000
70000000000000000000
700000ee000000000000
70000eaae00000000000
70000eaae00000000000
700000ee000000000000
70000000000000000000
70000000000000000000
70000000000000000000
70000000000000000000
70000000000000000000
70000000000000000000
70000000000000000000
70000000000000000000
70000000000000000000
70000000000000000000
7y000000000000000000
70000000000000000000
70000000000000000000
70000000000000000000
700000000b0000000000
700000000b0000000000
700000000b0000000000
700000000b0000000000
700000000b0000000000
700000000b0000000000
7000000a0b0000000000
7000000a0b0000000000
7000000a000000000000
7000000a000000000000
7000000a000000000000
7000000a000000000000
7000000a0b0000000000
7000000a0b0000000000
700000000b0000000000
700000000b0000000000
700000000b0000000000
500000000b0000000000
500000000b0000000000
500000000b0000000000
50000000000000000000
50000000000000000000
50000000000000000000
50000000000000000000
50000000000000000000
50000000000000000000
50000000000000000000
50000000000000000000
5x000000000000000000
50000000000000000000
50000000000000000000
50000000000000000000
50000000000000000000
50000000000000000000
50000000000ad0000000
50000000000ad0000000
50000000000000000000
50000000000000000000
