50000000000000000000
50000000000000000000
50000000000000000000
50000000000000000000
50000000000000000000
50000000000000000000
50000000000000000000
50000000000000000000
50000000000000000000
500000000bbb00000000
400000000bab00000000
400000000bbb00000000
40000000000000000000
40000000000000000000
40000000000000000000
4000000000000c000000
4000000000000c000000
4000000000000c000000
40000000000000000000
40000000000000000000
40000000000000000000
4x000000000000000000
40000000000000000000
40000000000000000000
40000000000000000000
40000000000000000000
40000000000000000000
40000000000000000000
40000000000000000000
40000000000000000000
40000000000ddd000000
400000000000a0000000
400000000000a0000000
40000000000ddd000000
60000000000000000000
60000000000000000000
60000000000000000000
60000000000000000000
60000000000000000000
60000000000000000000
60000000000000000000
60000000000000000000
6y000000000000000000
60000000000000000000
60000000000000000000
60000000000000000000
60000000000000000000
60000000000000000000
60000000000000000000
60000000000000000000
60000000000000000000
60000000000000000000
600000a0a00000000000
600000aea00000000000
600000aea00000000000
600000a0a00000000000
60000000000000000000
60000000000000000000
60000000000000000000
60000000000000000000
60000000000c00000000
60000000000b00000000
60000000000b00000000
60000000000a00000000
60000000000a00000000
50000000000b00000000
50000000000b00000000
50000000000c00000000
50000000000000000000
50000000000000000000
50000000000000000000
50000000000000000000
5x000000000000000000
50000000000000000000
50000000000000000000
50000000000000000000
50000000000a00000000
50000000000a00000000
50000000000b00000000
50000000000b00000000
50000000000b00000000
50000000000b00000000
50000000000a00000000
50000000000a00000000
50000000000000000000
40000000000000000000
4000000dd00000000000
4000000dd00000000000
40000000000000000000
40000000000000000000
40000000000000000000
40000000000000000000
4000000000a000000000
4000000000a000000000
4000000000e000000000
4000000000a000000000
4000000000a000000000
40000000000000000000
40000000000000000000
4y000000000000000000
40000000000000000000
40000000000000000000
40000000000000000000
4000000d000000000000
4000000d000000000000
4000000b000000000000
4000000b000000000000
5000000d000000000000
5000000d000000000000
50000000000c00000000
5000000000aca0000000
5000000000aca0000000
5000000000aca0000000
50000000000c00000000
50000000000000000000
50000000000000000000
50000000000000000000
50000000000000000000
50000000000000000000
50000000000000000000
50000000000000000000
50000000000000000000
5y000000000000000000
50000000000000000000
50000000000000000000
5000000000b000000000
5000000000b000000000
5000000000b000000000
